10
15
000000000001111
000000000033331
000001110032231
000000000032231
011100000033331
011100000000001
000000000000001
000000110001111
660000110001111
660000000001111