31
51
111111100000000000000000000000011111111111111111111
111111100000000000000000000000000011011111111111111
111111111000000000000000000000000011011111111111111
111111111000666600000000000000000011000000000000110
111111111000666600001111000000000011000000000000110
110000111000666600001111000666660011000000000000110
110000111000666600001111000666660011000220000000110
110000111000666600001111000666660011000220000000110
110000111000000000001111000666660011000220000000110
110000000000000000000110000666660011000000000000110
110000000000000000000110000666660011000000000000110
110000000000000077700110000666660011000000000000110
110000000000000077700110000000000011000000000000110
110000000000000077700110000000000011000000000000110
110000111111110000000000000000000011000011111110110
110000111111110000000000000000000011000017777710110
110000111111110000000000000000000000000017777710110
110000111111110000000000000077000000000017777710110
110000000000000000006660000077000000000017777710110
110000000000000000006660000000000000000017777710110
110000000000000000006660000000000000000017777710110
110000000077770000000000000000000000000011111110110
110000000077770000000000000000000000000000000000110
116666000077770000000000000000000000000000000000110
116666000077770000000000000000000000000000000000110
116666000000000000000000000000000000000000000000110
116666000000000000000000000000000000000000000000110
116666000000000000000000000000000000000000000000110
116666000000000000000000000000000000000000000000000
116666000000000000000000000000000000000000000000000
111111111111111111111111111111111111111111111111111
